Dogwhistle	Surface Forms	Surfaced by GPT-3
triple parentheses	triple parentheses; triple brackets; echo; ((())); the echo sign; (((echo))) 	1
Islamic extremism	Islamic extremism; radical Islamic extremism; extremism	1
Islamic extremists	Islamic extremists; Islamic extremist; radical Islamic extremists; radical Islamic extremist; extremist; extremists	1
Islamic terrorism	Islamic terrorism; radical Islamic terrorism; terrorism	1
Islamic terrorists	Islamic terrorists; Islamic terrorist; radical Islamic terrorists; radical Islamic terrorist; terrorist; terrorists	1
#GenderWooWoo	#GenderWooWoo; #genderwoowoo; gender woo woo	0
#Milk	#Milk; #milk; #MilkTwitter	0
#WomenWontWheesht	#WomenWontWheesht; #womenwontwheesht; women won't wheesht	0
Sonnenrad	☸️; Sonnenrad; Sunwheel; Black Sun; Sonnenrad emoji	0
two lightning bolt emojis	⚡⚡; doubled lightning emoji; two lightning bolt emojis	0
black and orange square emojis	⬛️🟧; black and orange square emojis; Super Straight; #SuperStraight	0
pine tree emoji	🌲; pine tree emoji; pine tree symbol 	0
cherry emoji	🍒; cherry emoji	0
checkered flag emoji	🏁; checkered flag emoji; chequered flag emoji	0
frog emoji	🐸 ; frog emoji	0
bear emoji	🐻; bear emoji	0
OK sign emoji	👌; OK sign; OK sign emoji; okay sign; okay sign emoji; okay emoji symbol	0
spiderweb emoji	🕸️; spiderweb emoji	0
milk emoji	🥛; milk emoji	0
red square emoji	🟥; red square emoji	0
suffragette flag emojis	🟪⬜🟩; 🟩⬜🟪; 💚🤍💜; 💜🤍💚; 💜🤍💛; 💛🤍💜; suffragette flag emojis; green white and purple emojis	0
lizard emoji	🦎; lizard emoji; salamander emoji	0
109	109;110	0
1290	1290; 1290 AD	0
13%	13%; 13/50; 13/52; 13/90	0
1488	14/88; 1488; 88; HH; 14 words	1
23/16	23/16; 16/23; 2316; 1623	0
41%	41%; 41; 41 percent	0
6MWE	6MWE; 6 million wasn't enough; six million wasn't enough	0
A Leppo	A Leppo	0
abolish birthright citizenship	abolish birthright citizenship; abolition of birthright citizenship; end birthright citizenship	1
absent fathers	absent fathers; absentee fathers; absent father; absentee father; lack of fathers	0
fatherless	fatherless; fatherless home; fatherless homes; fatherless child; fatherless children	1
baby daddies	baby daddy; baby daddies	0
deadbeat dad	deadbeat dad; deadbeat dads; deadbeat father; deadbeat fathers; deadbeat; deadbeats	1
actual woman	actual woman; actual women	0
adult human female	adult human female; adult human females	0
AFAB trans woman	AFAB trans woman; AFAB transgender woman; AFAB trans women; AFAB transgender women	0
affirmative action	affirmative action	1
agender	agender	1
Aiden	Aiden	0
alarmist	alarmist; alarmists; climate alarmist; climate alarmists	0
alarmism	alarmism; climate alarmism	0
All Lives Matter	All Lives Matter; #AllLivesMatter; #alllivesmatter; ALM; #ALM	1
alt-right	alt-right; alternative right; dissident right	1
America First	America First; #AmericaFirst	1
Amerimutt	Amerimutt; La Creatura; Le 56% Face; Der Untermensch; 56%	0
Amish	Amish	0
anchor babies	anchor baby; anchor babies	1
anointed	anointed; anointing	1
intact	intact male; intact female; intact man; intact woman	0
autoandrophilia	autoandrophilia	0
autoandrophile	AAP; AAPs; autoandrophile; autoandrophiles	0
autogynephilia	autogynophilia; autogynephilia	1
autogynephile	AGP; AGPs; autogynophile; autogynophiles; autogynephile; autogynephiles	0
balance the budget	balance the budget; balancing the budget	1
bankers	banker; bankers	1
banksters	bankster; banksters	1
Barack Hussein Obama	Barack Hussein Obama; Hussein Obama; Barack Hussein	1
based	based	0
be a man among men	be a man among men	0
beta	beta; beta male	1
big government	big government	1
big pharma	big pharma	1
Bing	Bing; Bings	0
biological realism	biological realism; biological reality	1
biological realist	biological realists; biological realist	0
bix nood	bix nood	0
black-on-black crime	black-on-black crime; black-on-black homicide; black on black crime; black on black homicide; black on black violence; black-on-black violence	1
blueish	blueish; bluish; blue	0
Boogaloo	boogaloo; boogalo; big igloo; big luau; the Hawaiian shirt	1
bop	bop; bopped; bops	0
brave and stunning	brave and stunning	0
bugman	bugman; bug-man; bugmen; bug-men	0
burning coal	burning coal; burn coal; burns coal; burned coal; burn the coal	0
coal burner	coal burner; coal burners	0
butterfly	butterfly; butterflies	0
cabal	cabal; shadowy cabal; global cabal; banking cabal; elitist cabal	1
car salesman	car salesman; car salesmen	0
Carolus Rex	Carolus Rex; Charles XII; Karl XII	0
centipede	centipede; nimble navigator; pede; centipedes; nimble navigators; pedes	0
central bankers	central banker; central bankers	0
children are being forced to transition	children are being forced to transition; forcing children to transition	1
citizens of nowhere	citizens of nowhere; citizen of nowhere; citizens of everywhere; citizen of everywhere	1
cleaning up our streets	clean up our streets; cleaning up our streets; clean up the inner city	1
climate realism	climate realism; climate-change realism; climate change realism	0
climate realist	climate realist; climate realists	0
Clown World	🤡🌎; Clown World; Honkler	0
clownfish	clownfish	0
coastal elite	coastal elite; coastal elites	1
New York elite	New York elite; New York elites; Manhattan elite; Manhattan elites	0
New York intellectual	New York intellectual; New York intellectuals	1
New York values	New York values	1
COIN	COIN; co-opting intersex narratives; COINing	0
coincidence	coincidence; coincidences; Cohencidence; Cohencidences	0
colorblind	color-blind society; colorblind; colorblindness; don't see color	1
cosmopolitan	cosmopolitan; cosmopolitans	1
cosmopolitanism	cosmpolitanism; cosmopolitan agenda	0
cosmopolitan elite	cosmopolitan elite; cosmopolitan elites	1
rootless cosmopolitan	rootless cosmopolitan; rootless cosmopolitans	1
countersemite	countersemite; counter-semite; countersemites; counter-semites	0
illegal aliens	illegal aliens; illegal alien; criminal illegal aliens; criminal illegal alien; criminal alien; criminal aliens	1
illegal immigrant	illegal immigrant; illegal immigrants; illegals	1
critical race theory	critical race theory; CRT; C.R.T.	0
Crusades imagery	Crusades imagery, insignia, symbols	0
cuck	cuck; cuckold; cuckservative; cucks; cuckolds; cuckservatives	1
cultural Marxism	cultural Marxism	1
cultural Marxists	cultural Marxists; cultural Marxist	1
cultural enrichment	cultural enrichment	1
culture enricher	culture enricher; culture enrichers; culture-enricher; culture-enrichers	0
cut taxes	cut taxes; cutting taxes; tax cut; tax cuts	1
deadly exchange	deadly exchange; deadly-exchange	0
deep state	deep state	1
Deus Vult	Deus vult; Deus Vult	0
did you see Kyle?	did you see Kyle?	0
dindu nuffin	dindu nuffin	0
dindu	dindu; dindus	0
dinosaur emojis	dinosaur emojis; 🦖; 🦕	0
discussion club	discussion club; discussion clubs	0
Dred Scott	Dred Scott; Dred Scott decision	0
dual citizen	dual citizen; dual citizens; dual citizenship	0
dual loyalty	dual loyalty; dual loyalties; disloyalty	1
Durden	Durden; Durdens	0
early life	early life; early life section; Wikipedia early life	0
economic anxiety	economic anxiety; working class anxiety	1
election integrity	election integrity; rigged election	1
entitlement spending	entitlement spending; government spending; government entitlement spending	1
erasing women	erasing women; erasure of women	1
every single time	every single time; E.S.T; EST	0
FAFO 	FAFO; F.A.F.O.	0
family values	family values; traditional family values	1
pro-family	pro-family	1
Federal Reserve	Federal Reserve; the Fed	0
fellow white people	fellow white people; as a white person; (((dear white people))); fellow whites; (((fellow whites)))	0
I have finished the race, I have kept the faith	I have finished the race, I have kept the faith	0
fishbucket	fishbucket; fishbuckets	0
food stamp president	food stamp president; food-stamp president	1
food stamps	food stamps; food stamp	1
forced busing	forced busing; forced bussing; mandatory busing; mandatory bussing	0
forced diversity	forced diversity	0
free helicopter rides	free helicopter rides; helicopter rides	0
freedom of association	freedom of association	0
fren	fren; frens; fren world	0
gangbanger	gangbanger; gangbangers; gang banger; gang bangers	1
gender abolitionist	gender abolitionist; gender abolitionists	0
gender abolition	gender abolition; abolish gender	0
gender critical	gender critical; gender-critical feminism; GC; gender crit; gendercrits; #gendercrit	1
gender skeptical	gender skeptical; gender skeptic; gender skeptics	0
gender fandom	gender fandom	0
gender ideology	gender ideology; gender identity ideology; radical gender ideology	1
gender socialization	gender socialization; male socialization; female socialization; socialized as male; socialized as female; gender socialisation; male socialisation; female socialisation; socialised as male; socialised as female	0
genderfree	genderfree; genderless	0
genderist	genderist; genderists	0
George Soros	George Soros; Soros	1
ghetto	ghetto; ghettos; ghettoes	1
gibsmedat	gibsmedat; gibs; gib me dat	0
special interests	special interest; special interests; global special interest; global special interests	0
globalist	globalist; globalists	1
globalism	globalism	1
Goody	Goody	0
Google	Google; Googles	0
entitlement programs	government entitlement program; government entitlement programs; entitlement program; entitlement programs; entitlement; entitlements	1
government handout	government handout; government handouts; handout; handouts	1
goy	goy; goyim	0
groomers	groomer; groomers	0
grooming	grooming; anti-grooming	0
gut welfare reform	gut welfare reform; gutting welfare reform; gutted welfare reform	0
hard-working Americans	hardworking American; hardworking Americans; hard-working Americans; hard-working American	1
he wuz a good boy	he was a good boy; he wuz a good boy	0
health freedom	health freedom; medical freedom	0
vaccine safety	vaccine safety; pro-vaccine safety; safe-vaxx	0
parents' right to choose	parents' right to choose	0
healthy tissue	healthy tissue	0
Hollywood elite	Hollywood elite; Hollywood elites; Hollywood; Hollywood liberals; Hollywood moguls	1
Holocauster	Holocauster; Holocausters	0
hygienic	hygienic	1
I Love J.K. Rowling	I Love J.K. Rowling; I Love JK Rowling; I Love Rowling; #ILoveJKRowling; I Stand with Rowling; I Stand with J.K. Rowling; I Stand with JK Rowling; #IStandWithJKRowling	0
identify as 	identify as	0
identitarianism	identitarianism; identitarian; identitarians	1
Illuminati	Illuminati	1
Roman imagery	Roman imagery, insignia, symbols	0
Medieval European imagery	Medieval (European) imagery, insignia, symbols	0
implicit bias	implicit bias; implicit biases	0
inner city	inner city; inner cities; inner-city; urban	1
institution of marriage	institution of marriage; traditional marriage	1
international bankers	international banks; international bankers; international banker	1
global elite	global elite; global elites; international elite; international elites	1
Islamists	Islamist; Islamists; radical Islamist; radical Islamists	1
Israel Lobby	Israel Lobby	1
it's okay to be white	it's ok to be white; it's okay to be white; #itsoktobewhite; #itsokaytobewhite	1
attacks on or imagery of Jewish financial leaders	Janet Yellen; Lloyd Blankfein; George Soros	1
job creators	job creator; job creators; job creation	1
jogger	jogger; joggers	0
Judas	Judas; 30 pieces of silver; thirty pieces of silver	0
Judeo-Christian	Judeo-Christian; Judeo-Christianity; Judeo-Christian values	1
judicial activism	judicial activism; judicial activist; judicial activists; activist judge; activist judges	1
Jwoke	Jwoke; JQ aware; J.Q. aware; JQ	1
Kalergi Plan	Kalergi Plan	1
Kek	Kek; Kekistan	1
Khazars	Khazar; Khazars	1
kosherist	kosherist; kosherists	0
law and order	law and order	1
lesbian erasure	lesbian erasure; erasing lesbians	1
lesbophobia	lesbophobia	0
Let's Go Brandon	Let's Go Brandon; LGB; #LGB	0
LGB rights	LGB rights; LGB; Drop the T; #DropTheT	0
lifelong bachelor	lifelong bachelor; single; never married; never-married; limp-wristed; has no children; confirmed bachelor	1
loxism	loxism; loxist; loxists	0
magapede	magapede; magapedes	0
majority-minority	majority-minority; majority minority	0
MAGA	MAGA; #MAGA; Make America Great Again	1
male violence	male violence	0
male-friendly content	male-friendly content; male-friendly	0
mass immigration	mass immigration; mass migration	1
merit-based immigration policy	merit-based immigration; merit-based immigration policy; skills-based immigration; skills-based immigration policy; points-based immigration; points-based immigration policy	1
middle class	middle class; middle-class Americans; middle class Americans	1
mixed sex	mixed sex; mixed-sex	0
multiculturalism	multiculturalism; multicultural; multiCULTi; multi-kulti	1
my sex is not a costume	my sex is not a costume; #WomanNotACostume; #MySexIsNotACostume; woman not a costume	0
neoliberal	neoliberalism; neoliberal; neoliberals; neolib; neolibs	1
New World Order	New World Order; NWO	1
nibba	nibba; nibbas; ni🅱️🅱️a; ni🅱️🅱️as	0
non-affirming therapist	non-affirming therapist; non-affirming therapists; non-affirming therapy	0
nose check	nose check	0
noticer	noticer; noticers; #TheNoticing	0
NPC	NPC; Wojak; NPCs; Wojaks	0
octopus	octopus	0
open borders for Israel	open borders for Israel; #OpenBordersForIsrael	0
our guy	our guy; /our guy/	0
overpopulation	overpopulation; overpopulating our country; overpopulating our planet; overpopulating the planet	1
oy vey	oy vey	0
Pajeet	Pajeet; Pajeets	1
Pepe the Frog	Pepe the Frog; Pepe; Feels Good Man	0
personal responsibility	personal responsibility; individual responsibility	1
physical removal	physical removal	0
pilpul	pilpul	0
poisoning the well	poison the well; poisoning the well	0
political correctness	political correctness; politically correct	1
power level	power level	0
preemptive strike	pre-emptive strike; preemptive strike	0
"prefix ""super"""	superstraight; superlesbian	0
property rights	property rights; protecting property rights	1
protecting women and girls	protect women and girls; protecting women and girls; protecting women's spaces; protect women's spaces; defend women and girls; defending women and girls	1
public school	public school; public schools	0
puppet masters	puppet master; puppet masters	1
quotas	quota; quotas; racial quotas; diversity quotas	1
race realism	race realism; racial realism; human biodiversity; HBD; scientific racism; race realist; race realists	1
radical Islam	radical Islam	1
RaHoWa	RaHoWa; #RaHoWa	0
Reagan	Reagan; Reagans	0
references to cities with large Black populations being overrun by crime, drugs, rodents	Chicago; Detroit; Cleveland; Baltimore	1
religious freedom	religious freedom; religious liberty; freedom of religion; religious liberties; God-given liberties; God-given liberty	1
Remove Kebab	Remove Kebab; Serbia Strong; Dat Face Soldier; kebab removal; kebab removalist; removing kebab	0
right to know	just label it; right to know	0
right to work	right to work; economic freedom; freedom to work; right-to-work laws	1
Rothschilds	Rothschild; Rothschilds; Rothschild family	1
run your own schools	run your own schools; running your own schools; local control of schools	0
RWDS	RWDS	0
safeguarding	safeguard; safeguarding; safeguarding children; child safeguarding	1
save women's sports	save women's sports; save girls' sports; protect women's sports	1
school choice	school choice; school vouchers; education reform; educational choice; parental choice	1
secure the border	secure the border; securing the border; secure our border; securing our border	1
security from unrest	security from unrest; safety from unrest	0
send me	send me	0
sex is real	sex is real; #SexIsReal; biological sex is real	1
sex-based rights	sex-based rights; women's sex-based rights	1
sex not gender	sex not gender; #SexNotGender	0
Sharia law	Sharia law; Shariah law; Sharia; Shariah	1
shekels	shekels; shekel	0
Shlomo	Shlomo; Schlomo	0
shoah	shoah; shoah'd; shoahed	0
attacks on or imagery of Jewish political leaders	Sidney Blumenthal; Bernie Sanders; Volodymyr Zelensky	0
silent majority	silent majority	1
Skittle	Skittle; Skittles	0
Skype	Skype; Skypes	0
snowflake	snowflake; snowflakes	1
social justice warrior	social justice warrior; social justice warriors; SJW; SJWs	1
soy boy 	soy boy; soy; soyboi; soybois; soy boys	1
SPQR	SPQR	0
Staniland question	Staniland question	0
states' rights	states' rights	1
steroids	steroids	0
strapping young buck	strapping young buck; buck; young buck	1
string puller	string puller; string pullers; string-puller; string-pullers	0
pulling strings	pull the strings; pulling the strings; pulling strings	1
superpredators	superpredator; superpredators; super predator; super predators	1
surgical wound	surgical wound; surgical wounds; surgical cavity	0
SWPL	SWPL	0
take back	take back; take back our country; take our country back	1
biological man	biological man; biological men; natal man; natal men; biological male; biological males	1
biological woman	biological woman; biological women; natal woman; natal women; biological female; biological females	1
controlled media	controlled media; media control	1
the goyim know	the goyim know; the goyim know shut it down; shut it down; da goyim know	0
welfare queen	welfare queen; welfare queens; the welfare queen	1
Three Percenters	Three Percenters; 3%ers; III%ers	0
thug	thug; thugs	1
Trans Identified Female	TIF; Trans Identified Female; TIFs; Trans Identified Females; trans-identified female; trans-identified females	0
Trans Identified Male	TIM; Trans Identified Male; TIMs; Trans Identified Males; trans-identified male; trans-identified males	1
tiny minority of men	tiny minority of men; fraction of the patriarchy	0
tough on crime	tough on crime	1
three strikes laws	three strikes; three strikes laws; three strikes policies; three strikes policy; three strikes law	0
TRAs	trans-rights activist; trans-rights activists; trans rights activist; trans rights activists; TRA; TRAs; trans activist; trans activists	1
Trilateral Commission	Trilateral Commission	1
troon	troon; troons	0
uterus-haver	uterus-haver; uterus-havers; uterus haver; vagina haver; front holer	0
vegan cat	vegan cat	0
Vinland	Vinland	0
voter fraud	voter fraud; voting fraud; fraudulent voting	1
war on Christmas	war on Christmas	1
war on crime	war on crime	1
war on drugs	war on drugs	1
war on terror	war on terror; war on terrorism	1
war on women	war on women	1
we wuz kangz	we wuz kangz; we wuz kings; we wuz kangz n shieet; we wuz kangs	0
welfare	welfare; welfare reform	1
welfare cheats	welfare cheat; welfare cheats	1
who nose?	who nose?	0
Willie Horton	Willie Horton	1
windmill	windmill; windmill of friendship	0
womanface	womanface	0
womyn	womyn; wombyn; womxn	0
wonder-working power	wonder-working power	0
China Virus	China Virus; Wuhan Virus; Kung Flu	1
XX	XX	1
Yahoo	Yahoo; Yahoos	0
YKW	YKW; you know who	0
you can identify as anything you'd like	you can identify as anything you'd like; you can identify as whatever you like; you can identify as anything you like; you can identify as whatever you'd like	0
YWNBAW	YWNBAW	0
Zionist	Zionist; Zionists; Zio; Zios	1
Zionist Occupation Government	Zionist Occupation Government; Zionist-occupied Government; ZOG; Z0g; z0g; zog	1
Zioworld	Zioworld	0
broken family	broken family; broken home; broken families; broken homes	1
out of wedlock	out of wedlock	1
baby mama	baby mama; baby mamas; baby momma; baby mommas	1
working class	working families; working class; working-class; working class families; working-class communities; working class communities; working-class families	1
single parent	single parent; single-parent household; single mom; single mother	1
White Lives Matter	White Lives Matter; #WhiteLivesMatter; WLM; #WLM	1
thin blue line	thin blue line; thin blue line flag	0
Blue Lives Matter	Blue Lives Matter; #BlueLivesMatter	1
Back the Blue	#BackTheBlue; back the blue; Back the Blue	0
